55555555552222222222222222222222222222222222222222222222222222222
55552222255222222222222222222222222222222222222222222222222222222
55525555525522122222255555555522222222255555555522222255555555222
55255555552551122222255555555522222222255555555521111255555555222
52115555555255122112255555555555555555555555555522222255555555222
52111111111555555555555555555555555555555555555522222255555555222
52111111111555555555555555555522222222255555555555555555555555222
52115515555555555555555555555522222222255555555522222255555555222
52555515555252222222255555555522222222222222222222222255555555222
55255515552552222222255555555522222222222222222222222255555555222
55525515525522222222255555555522222222222222222222222255555555222
25552212255222222222222222222222222222222222222222222255555555222
22555515552222222222222222222222222222222222222222222255555555522
22222212222222222222222212222222222222222222222222222222222222222
22222212222222222222222212222222222222222222222222222222222222222
22222212222222222222222212222222222222222222222222222222222222222
22222212222222222222222222222222222222222222222222222222222222222
22222212222222222222222222222222222222222222222222222222222222222
22255555555555555222222222222222222222222222222222222222222222222
22255555555555555222222222222222222222222222222222222222222222222
22222222222222222222222222222222222222222222222222222222222222222
22222222222222222222222222222222222222222222222222222222222222222
22222222222222222222222222222222222222222222222222222222222222222
22222222222222222222222222222222222222222222222222222222222222222
22222222222222222222222222222222222222222222222222222222222222222
22222222222222222255555551555555552222222222222222222222222222222
22222222222222222255555551555555552222222222222222222222222222222
22222222222222222255555551555555552222222222222222222222222222222
22222222222222222255555551555555552222222222222222222222222222222
22222222222222222255555551555555552222222222222222222222222222222
22222222222222222211111111111111112222222222222222222222222222222
22222222222222122255555551555555552222222222222222222222222222222
22222222222222222255555551555555552222222222222222222222222222222
22222222222222222255555551555555552222222222222222222222222222222
22222222222222222255555551555555552222222222222222222222222222222
22222222222222222255555555555555552222222222222222222222222222222
22222222222222222222222222222222222222222222222222222222222222222
22222222222222222222222222222222222222222222222222222222222222222
22222222222222222222222222222222222222222222222222222222222222222
22222222222222222222222222222222222222222222222222222222222222222
22222222222222222222222222222222222222222222222222222222222222222
22222222222222222222222222222222222222222222222222222222222222222
22222222222222222222222222222222222222222222222222222222222222222
22222222222222222222222222222222222222222222222222222222222222222
