445444544444
544454444344
444444422222
454444321112
444544421112
545454421112
444444421112
444444421112
544544321112
454444422222
444444444344
454544544444
