44444444555555555544444444444444444444444444444444444444444444444444444444
44444444555521222554444444442222222222244444444222222222244442222222222444
44444444555254445255444444442444444444244444444444444444244442444444442444
44444444552554445525444444442444444444222222222444444444244442444444442444
44444444524455555552551221122444444444444444444444444444244442444444442444
44444444521111111114444444444444444444444444444444444444222222444444444444
44444444521111111114444444444444444444222222222444444444444444444444444444
44444444524455155444444444444444444444244444442444444444222444444444442444
44444444525544144552522222222444444444244444442222222222244442444444442444
44444444552555154524444444442444444444244444444444444444444442444444442444
44444444445255155244444444444444444444244444444444444444422222444444442444
44444444445522122444444444442222222222444444444444444444422222444444442444
44444444444445154444444444444444222444444444444444444444422222444422245444
44444444444442124444444444444222122222444444444444444444422244422222222444
44444444444442124444411444444244444442444444444444444444422244444422244444
44444444444442124444111144444444444442444444444444444444422244444222222244
44444444444442124444111144444444444442444444444444444444422244422222222244
44444444444442124444411444444222222222444444444444444444422244422222222244
44444444444442224444444444444444222444444444444444444444422244422222222244
44444444444442224444444444444444222444444444444444444444422244422422222244
44444444444442224444444444444444222222224444444444444444422244444422244444
44444444444442224444444444444444222222224444444444444444422222222222222222
44444444444442224444444444444444222222224444444444444444422444444422244442
44444444444442224444444444444444444422224444444444444444424444444444444442
44444444222444222222224444444422222222222212222444444444424444444444444442
44444444244444444444424444444422444442244444222444444444424444444444444442
44444444244444444444424444444424444442244444422444444444424444444444444442
44444444244444444444424444444444444442244444442444444444424444444444444442
44444444244444444444424444444444444422224444442444444444424444444444444442
44444444244444444444422222222544444222222444442222222222222444444444444442
44444444244444444444422222222122222222222222222222222222222444444444444442
44444444244444444444421222222222222222222222222222222222222444444444444442
44444444222222222222222222222444444222222444442222222222222444444444444442
44444444444421244444444444444444444422224444442444444444424444444444444442
44444444444421244444444444444444444442244444442444444444424444444444444444
44444444444421244444444444444524444442244444422444444444424444222444444444
44444444444222212244444444444222444442244444222444444444422222222222222222
44444444444222222244444444444222222222222222222444444444444444222444444444
44444444444222222244444444444444444422224444444444444444444444222444444444
44444444444222222244444444444444444422224444444444444444444444222444444444
44444444444222222244444222224444444422224444444444444444444444222444444444
44444444444422244444444111144444444422224444444444444444444444222444444444
44444444444422244444444111144444444422224444444444444444444444222444444444
44444444222222244442444111144444444422222222224444444444444444222444444444
44444444244422244444444411444444444422222222224444444444444444222444444444
44444444244442244424221411412244444422222222224444444444444444222444444444
44444444244444244424221111112242444444444442224444444444444444222444444444
44444444244444244444221411412242444422222222222444444444444444222444444444
44444444244444244444444411444442444424444442224444442444444444222444444444
44444444244444244444444411444442444424444444444444442444444444224444444444
44444444244444244444444411444444444424444444444444422222222222224444444444
44444444244444244444444411444244444424444444444444422222222222224444444444
44444444242224244444444222242444444424444444444444422222222224444444444444
44444444222244244444442422224444444424444444444444442444444444444444444444
44444444442244444444444222244444444424222444444444442444444444444444444444
44444444442224444444444222444444444422222222222222222444444444444444444444
44444444442224442222222222222222224444222444444444444444444444444444444444
44444444442224442444444222244444424444222444444444444444444444444444444444
44444444442224444444444444444444424444222444444444444444444444444444444444
44444444442244442244444444444444222222222444444444444444444444444444444444
44444444422244422444444444444442222222224444444444444444444444444444444444
44444444444222222244444444444444244444444444444444444444444444444444444444
44444444444444444244444444444444244444444444444444444444444444444444444444
44444444444444444444444444444444444444444444444444444444444444444444444444
44444444444444444444444444444444444444444444444444444444444444444444444444
44444444444444444444444444444444444444444444444444444444444444444444444444
44444444444444444444444444444444444444444444444444444444444444444444444444
