555555555544444444447777777777744444444444444444444444444444477455
555522222554444444442222222222244444444222222222244442222222222754
555254443255444444442417777715244444444555344455244442444444172745
552554445525444444442316666614222222222544444445244442444444172744
524455555552551221122341111154422111124444544445244442444444172774
521111111114544335544444445544421122224444444443222222444444174764
521111111114444554444444444443222222222554444444111111444444174744
524453155444433455444444444444233555332345554444222444444444172734
523544144552522222222544444445243444452222222222244442444444172735
552555154525533555352534444445243435444554345535444442444444172745
445255155255444444554555444444245444444434444443322222444444172775
445522125554444444452222222222455343444444444444322222444444172774
544455155344444444443555222433554344444444455444422222444422275774
454452123444444444445222122222544444444344544544422244422222222774
444432123554444445445222222222544443444443444544322553444422277774
444442125444444435444222222222544444444444344544322255444222222275
444442125554444544444422222222443444444444444444422245422222222275
444452125443444444444222222222444444444444444444422245422222222275
444352225544544444444555222444444434534444444454522244322222222274
444342225434444445444443222444434444454444434444522234422422222274
444542225445444444354443222222233445455344444544322244444422247774
544442225444444444445445222222224444445544444444322222222222222222
554442224544444444444345222222223344444444344444422355555522255172
535442225555444444444444444422224333444444444444425544454444445172
222444222222225444445422222222222212222444444444425544554444443172
235542224543325544445422355442244444222544444444525444444444444172
234445444454325545443424444452244434422544444444425444444444444172
254454444454525444454444444452243444442554444444524444444444544172
254455444444524444444454444522225534442555444555524444444444554172
234444444534222222222554443222222544442222222222222444444444554172
235444443544212222222122222222222222222222222222222444444444445172
245322233444211222222222222222222222222222222222222445444444444172
222222222222222222222434443222222444432222222222222453544444444172
444421254444444444555444444522223444452445333545525454444444444172
444421255444444444445444444452234444452444444444325444444444444174
444421255544444444454524434452244444522454444444524444222444444174
444222212244444444454222344442234443222454444444522222222222222222
444222222244444444445222222222222222222554444444455555222444447777
444222222254445444444444555522225554555444444444444455222444477777
444222222254445554444444445522225454444444444444444443522444477777
444222222254444222224444444522225444444453543444444445522444777777
444422255444443111154444444422224444544444445444444445222447777777
444422254444445111145444444422224545544444444555444444222447777777
222222244442534111145344444522222222255444444544454444222447777777
255322254445444411445444444522222222225544444444435444222477777777
254442244523221411412234444422222222225355444544444444222477777777
244444244423221111112232454444444442225454444544444444222477777777
243445254445221411512242454422222222222444444544444444222467777777
244445254554444411455542445425335442223354442535444444222446777777
244445254544544411444342445523544454544443542445545554224444777777
254443244454554411443444444525444444455544422222222222224444677777
234444244445455511444244444524444444444444422222222222224444467777
252224244445545222242544444325444444444444422222222224444444456777
222244244445452422225544444325454444444344452444444444444444454667
542245534444445222255544444425222444433444452444444444444444455446
342225444344455222445554444422222222222222222444445554444444445544
542224442222222222222222224444222444444444444444444445444454444454
352224442555355222255534424444222444444444444444544444444454444444
452225544544445354444445424444222444444444444444444444444544444445
452244452244444454444344222222222444444444444454444445445444455445
442224442244444444444444222222222444444444445544455444444444544445
444222222254444434444444244444444444444445554445444444444455444445
444444444255444444444444244444444444444444444444444455555444445445
444444444545544444444444344444444444444444444444455544444444554444
444444444544454544443355444444444444444444444444455544444444444445
444444444444444444444444444444444554545455545545454455444455555445
444444444444444444444444444444444445444445444455555554555544545544
