000000000000
000000000000
000054444000
000555445500
005544444550
005444444445
005444544445
005444551554
005544511550
000555545500
000055555000
000000000000
