455555555544444444444444444444444444444444444444444444444444444444
555521222554444444442222222222244444444222222222244442222222222444
555254445255444444442444444444244444444444444444244442444444442444
552554445525444444442444444442222222222244444444244442444444442444
524455555522551222222244444442222222222244444444244442444444442444
521111111122222222222244444442222222222244444442222222244444444444
521111111122222222222244444442222222222244444442222222244444444444
524455155422222222222244444444244444442444444442222444244444442444
525544144522522222222244444444244444442222222222244442444444442444
552555154524444444442444444444244444444444444444444442444444442444
445255155244444444444444444444244444444444444444422222444444442444
445522122444444444442222222222444444444444444444422222444444442444
444445154444444444444444222444444444444444444444422222444422245444
444442124444444444444222122222444444444444444444422244422222222444
444442124444444444444244444442444444444444444444422244444422244444
444442124444444444444444444442444444444444444444422244444222222244
444442124444444444444444444442444444444444444444422244422222222244
444442124444444444444222222222444444444444444444422244422222222244
444442224444444444444444222444444444444444444444422244422222222244
444442224444444444444444222444444444444444444444422244422422222244
444442224444444444444444222222224444444444444444422244444422244444
444442224444444444444444222222224444444444444444422222222222222222
444442224444444444444444222222224444444444444444422244444422244442
444442224444444444444444444422224444444444444444422444444444444442
222444222222224444444422222222222212222444444444424444444444444442
244444444444424444444422444422224444222444444444424444444444444442
244444444444424444444424444442244444422444444444424444444444444442
244444444444424444444444444442244444442444444444424444444444444442
244444444444424444444444444422224444442444444444424444444444444442
244444444444422222222524444222222444422222222222222444444444444442
244444444444422222222122222222222222222222222222222444444444444442
244444444444421222222222222222222222222222222222222444444444444442
222222222222222222222424444222222444422222222222222444444444444442
444421244444444444444444444422224444442444444444424444444444444442
444421244444444444444444444442244444442444444444424444444444444444
444421244444444444444524444442244444422444444444424444222444444444
444222212244444444444222444422224444222444444444422222222222222222
444222222244444444444222222222222222222444444444444444222444444444
444222222244444444444444444422224444444444444444444444222444444444
444222222244444444444444444422224444444444444444444444222444444444
444222222244444222224444444422224444444444444444444444222444444444
444422244444444111144444444422224444444444444444444444222444444444
444422244444444111144444444422224444444444444444444444222444444444
222222244442444111144444444422222222224444444444444444222444444444
244422244444444411444444444422222222224444444444444444222444444444
244442244424221411412244444422222222224444444444444444222444444444
244444244424221111112242444444444442224444444444444444222444444444
244444244444221411412242444422222222222444444444444444222444444444
244444244444444411444442444424444442224444442444444444222444444444
244444244444444411444442444424444444444444442444444444224444444444
244444244444444411444444444424444444444444422222222222224444444444
244444244444444411444244444424444444444444422222222222224444444444
242224244444444222242444444424444444444444422222222224444444444444
222244244444442422224444444424444444444444442444444444444444444444
442244444444444222244444444424222444444444442444444444444444444444
442224444444444222444444444422222222222222222444444444444444444444
442224442222222222222222224444222444444444444444444444444444444444
442224442444444222244444424444222444444444444444444444444444444444
442224444444444444444444424444222444444444444444444444444444444444
442244442244444444444444222222222444444444444444444444444444444444
442224442244444444444444222222222444444444444444444444444444444444
444222222244444444444444244444444444444444444444444444444444444444
444444444244444444444444244444444444444444444444444444444444444444
444444444444444444444444444444444444444444444444444444444444444444
444444444444444444444444444444444444444444444444444444444444444444
444444444444444444444444444444444444444444444444444444444444444444
444444444444444444444444444444444444444444444444444444444444444444
