444444444444444444444444444447777777664444444444444444444444444444444444444444477777
444441444444444444444444444447777777444444444444444444444444444444444444444447777777
444444444444444444444444444447777777744444444444444444444444444444444444447777777777
444444444444444444444444444446777776644444444444444444444444444444444444777777777777
444444444444444444444444444444677774444444444444444444444444444444444447777777777777
444444444444444444444444444444467774444444444444444444444444444444444477777777777777
444444444444444444444444444444447774444444444444444444444444444444444777777777777777
444444444444212224444444444422222272222444444442222222222444422222222777777777777777
444444444442544452444444444424417771442444444445545444552444425445552727777777777777
444444444445544455244444444424516661412222222221444444452444425444552777777777777777
444444444244555555125512211221411111411111111111444554442444425544452777777777777777
444444444251113155111111111111444444411111111111454454412222221444442777777777777777
444444444213131151111111111111444445412222222221554444411111111444442747777777777777
444444444244555554111111111111544445542444444425544444412224441454542727777777777777
444444444455445445125222222221444444552444444422222222222444424444542727777777777777
444444444445555545144444444425444444452444444444444444444444424444442727777777777777
444444444444555552444444444445551114542444444444444444444222221544542727777777777777
444444444444421224444444444422222222224444444444444444444222221445542777777777777777
444444444444452544444444444444442224444444444444444444444222221444222777777777777777
444444444444422244444444444442221222224444444444444444444222444222222227777777777777
444444444444422244444444444442211212224444444444444444444222444444222777777777777777
444444444444422244444444444444122221224444444444444444444222444442222222777777777777
444444444444451244444444444444111111124444444444444444444222444222222222777777777777
444444444444421244444444444444222222224444444444444444444222444222222222777777777777
444444444444422244444444444444442224444444444444444444444222444222222222777777777777
444444444444422244444444444444442224444444444444444444444222444224222222777777777777
444444444444422244444444444444442222222244444444444444444222444444222777777777777777
444444444444422244444444444444442222222244444444444444444222222222222222727777777777
444444444444422244444444444444442222222244444444444444444221666666222666727777777777
444444444444422244444444444444444444222244444444444444444211111111111111727777777777
444444442224442222222244444444222222222222122224444444444271543344444441727777777777
444444442455422244555244444444224533111143442224444444444271544444355541727777777777
444444442544444444455244444444243444422444444224444444444271544444444441727777777777
444444442545444454445244444444544444422345444424444444444271444444444441727777777777
444444442444444444444244444444543444222244453424444444444271444544444441727777777777
444444442544444444452222222225155532222224455122222222222221544455444451727777777777
444444442544444445452222222221122222222222222122222222222221545445544451727777777777
444444442554222455552212222222122222222222222122222222222221535444444341727777777777
444444442222222222222222222224144442222224445122222222222221554444555341727777777777
444444444444212444444444444444443444222244345524444444444271454444444441727777777777
444444444444212444444444444444444444422444443424444444444271111111111111747777777777
444444444444212444444444444445245554422444544224444444444266662226666666677777777777
444444444442222122444444444442224444111144552224444444444222222222222222727777777777
444444444442222222444444444442222222222222222224444444444444442224444447777777777777
444444444442222222444444444444444444222244444444444444444444442224444447777777777777
444444444442222222444444444444444444222244444444444444444444442224444447777777777777
444444444442222222444442222244444444222244444444444444444444442224444447777777777777
444444444444222444444451111544444444222244444444444444444444442224444446777777777777
444444444444222444444531111535444444222244444444444444444444442224444444777777777777
444444442222222444425441111445444444222222222244444444444444442224444444777777777777
444444442554222444454455113445544444222222222244444444444444442224444444777777777777
444444442554422444252215114122544444222222222244444444444444442224444444777777777777
444444442445442444252211111122524444444444422244444444444444442224444444777777777777
444444442445442444452214114122524444222222222224444444444444442224444444677777777777
444444442445442444454454114354524444255554422244455424444444442224444444477777777777
444444442455542444453345115545524444254544444444444524444444442244444444467777777777
444444442444452444445445114435444444254544444445444222222222222244444444446777777777
444444442544442444444544114452444444244544444444444222222222222244444444444667777777
444444442422242444444452222524444444244444544444444222222222244444444444444447777777
444444442222442444444424222244444444254444444554445424444444444444444444444446677777
444444444422444444444442222444444444242224444445554424444444444444444444444444466777
444444444422244444444442224444444444222222222222222224444444444444444444444444444667
444444444422244422222222222222222244442224444444444444444444444444444444444444444446
444444444422244424444442222444444244442224444444444444444444444444444444444444444444
444444444422244444444444444445554244442224444444444444444444444444444444444444444444
444444444422444424445444444455442222222224444444444444444444444444444444444444444444
444444444422444222444444444445442222222244444444444444444444444444444444444444444444
444444444442222222454454444444542444444444444444444444444444444444444444444444444444
444444444444444442444544445544442444444444444444444444444444444444444444444444444444
444444444444444444544444444444444444444444444444444444444444444444444444444444444444
444444444444444444455545544444444444444444444444444444444444444444444444444444444444
444444444444444444444444444444444444444444444444444444444444444444444444444444444444
444444444444444444444444444444444444444444444444444444444444444444444444444444444444
444444444444444444444444444444444444444444444444444444444444444444444444444444444444
444444444444444444444444444444444444444444444444444444444444444444444444444444444444
444444444444444444444444444444444444444444444444444444444444444444444444444444444444
444444444444444444444444444444444444444444444444444444444444444444444444444444444444
444444444444444444444444444444444444444444444444444444444444444444444444444444444444
