000000000000000000000000000000000000000000000000000000000000000000000000000000000000000000000
000000000000000000000000000000000000000000000000000000000000000000000000000000000000000000000
000000000000000000000000000000000000000000000000000000000000000000000000000000000000000000000
000000000000000000000000000000000000000000000000000000000000000000000000000000000000000000000
000000000000000000000000000000000000000000000000000000000000000000000000000000000000000000000
000000000000000000000000000000000000000000000000000000000000000000000000000000000000000000000
000000000000000000000000000000000000000000000000000000000000000000000000000000000000000000000
000000000000111140000000000011333331111000000011111111111000011111111110000000000000000000000
000000000004000004000000000010000000001000000010000000001000010000000010000000000000000000000
000000000040000000100000000010000000001133311110000000001000010000000010000000000000000000000
000000000100100040013333333110000000005000000500000000001000010000000010000000000000000000000
000000000400000000005000000050000000005000000500000000001111110000000010000000000000000000000
000000000100000000005000000050000000003133131110000000000500050000000010000000000000000000000
000000000100400040005000000050000000001000000010000000001111110000000010000000000000000000000
000000000100000000011333331310000000001000000011111111111000010000000010000000000000000000000
000000000010000000100000000010000000001000000000000000000000010000000010000000000000000000000
000000000001000001000000000010000000001000000000000000000111110000000010000000000000000000000
000000000000110440000000000011312011111000000000000000000100050000000010000000000000000000000
000000000000010100000000000000002020000000000000000000000101110000000010000000000000000000000
000000000000010100000000000003443034430000000000000000000101011111101110000000000000000000000
000000000000010100000000000003000000030000000000000000000101000000101000000000000000000000000
000000000000010100000000000003000000030000000000000000000101000144304331000000000000000000000
000000000000010100000000000001000000010000000000000000000101000100000004000000000000000000000
000000000000010100000000000004131013410000000000000000000101000100000001000000000000000000000
000000000000010100000000000000001010000000000000000000000101000100000001000000000000000000000
000000000000010100000000000000001010000000000000000000000101000431104413000000000000000000000
000000000000010100000000000000001011113300000000000000000101000000101000000000000000000000000
000000000000010100000000000000001000000300000000000000000202222222202222220000000000000000000
000000000000010100000000000000001111100300000000000000000200000000000000020000000000000000000
000000000000010100000000000000000000100300000000000000000200000000000000020000000000000000000
000000001111110111111100000002222222200222222220000000000200000000000000020000000000000000000
000000001000000000000100000002000000000000000020000000000200000000000000020000000000000000000
000000001000000000000100000002000000000000000020000000000200000000000000020000000000000000000
000000001000000000000100000002000000000000000020000000000100000000000000020000000000000000000
000000001000000000000100000002000000000000000020000000000200000000000000020000000000000000000
000000001000000000000133333332000000000000000023311111111200000000000000020000000000000000000
000000001000000000000050000005000000000000000005000000000500000000000000020000000000000000000
000000001000000000000150000005000000000000000005000000000500000000000000020000000000000000000
000000001111101111111333333332000000000000000023333333333200000000000000020000000000000000000
000000000000101000000000000002000000000000000020000000000200000000000000020000000000000000000
000000000000101000000000000002000000000000000020000000000200000000000000020000000000000000000
000000000000101000000000000002000000000000000020000000000200000000000000020000000000000000000
000000000001101111000000000002000000000000000020000000000222222022222222220000000000000000000
000000000001000001000000000002222222200222222220000000000000001010000000000000000000000000000
000000000001000001000000000000000000100100000000000000000000001010000000000000000000000000000
000000000001000001000000000000000000100100000000000000000000001010000000000000000000000000000
000000000001101111000022222200000000100100000000000000000000001010000000000000000000000000000
000000000000101000000200000020000000100100000000000000000000001010000000000000000000000000000
000000000000101000002000000002000000100100000000000000000000001010000000000000000000000000000
000000001111101000020000000000200000100111111100000000000000001010000000000000000000000000000
000000001000001000200000000000020000100000000100000000000000001010000000000000000000000000000
000000001000001000200000000000020000111111110100000000000000001010000000000000000000000000000
000000001000001000200000000000020000000000010100000000000000001010000000000000000000000000000
000000001000001000200000000000020000111111110111111110000000001010000000000000000000000000000
000000001000001000200000000000020000100000000000000010000000001010000000000000000000000000000
000000001000001000200000000000020000100000000000000010000000001010000000000000000000000000000
000000001000001000020000000000200000100000000000000011111111111010000000000000000000000000000
000000001000001000002000000002000000100000000000000005000000000010000000000000000000000000000
000000001000001000000200000020000000100000000000000011111111111110000000000000000000000000000
000000001110111000000022002200000000100000000000000010000000000000000000000000000000000000000
000000000010100000000001001000000000100000000000000010000000000000000000000000000000000000000
000000000010100000000001001000000000111011111111111110000000000000000000000000000000000000000
000000000010100011111111001111111100001010000000000000000000000000000000000000000000000000000
000000000010100010000000000000000100001010000000000000000000000000000000000000000000000000000
000000000010100010000000000000000100001010000000000000000000000000000000000000000000000000000
000000000010100010000000000000000111111010000000000000000000000000000000000000000000000000000
000000000010111110000000000000000050000010000000000000000000000000000000000000000000000000000
000000000010000050000000000000000111111110000000000000000000000000000000000000000000000000000
000000000011111110000000000000000100000000000000000000000000000000000000000000000000000000000
000000000000000010000000000000000100000000000000000000000000000000000000000000000000000000000
000000000000000010000000000000000100000000000000000000000000000000000000000000000000000000000
000000000000000011111111111111111100000000000000000000000000000000000000000000000000000000000
000000000000000000000000000000000000000000000000000000000000000000000000000000000000000000000
000000000000000000000000000000000000000000000000000000000000000000000000000000000000000000000
000000000000000000000000000000000000000000000000000000000000000000000000000000000000000000000
000000000000000000000000000000000000000000000000000000000000000000000000000000000000000000000
000000000000000000000000000000000000000000000000000000000000000000000000000000000000000000000
000000000000000000000000000000000000000000000000000000000000000000000000000000000000000000000
