0000000000000000000000000000000000000000000000000000000000000000000000000000000000000
0000111140000000000011111111111000000011111111111000011111111110000000000000000000000
0004000004000000000010000000001000000010000000001000010000000010000000000000000000000
0040000000100000000010000000001111111110000000001000010000000010000000000000000000000
0100100040011111111110000000000000000000000000001000010000000010000000000000000000000
0400000000070000000000000000000000000000000000001111110000000010000000000000000000000
0100000000070000000000000000001111111110000000000000000000000010000000000000000000000
0100400040000000000000000000001000000010000000001111110000000010000000000000000000000
0100000000011111111110000000001000000011111111111000010000000010000000000000000000000
0010000000100000000010000000001000000000000000000000010000000010000000000000000000000
0001000001000000000010000000001000000000000000000111110000000010000000000000000000000
0000110440000000000011111011111000000000000000000100000000000010000000000000000000000
0000010100000000000000001010000000000000000000000101110000000010000000000000000000000
0000010100000000000001111011110000000000000000000101011111101110000000000000000000000
0000010100000000000001000000010000000000000000000101000000101000000000000000000000000
0000010100000000000001000000010000000000000000000101000111101111000000000000000000000
0000010100000000000001000000010000000000000000000101000100000001000000000000000000000
0000010100000000000001113031110000000000000000000101000100000001000000000000000000000
0000010100000000000000003030000000000000000000000101000100000001000000000000000000000
0000010100000000000000003030000000000000000000000101000111101111000000000000000000000
0000010100000000000000003033333300000000000000000101000000101000000000000000000000000
0000010100000000000000003000000300000000000000000101111111101111110000000000000000000
0000010100000000000000003333300300000000000000000100000000000000010000000000000000000
0000010100000000000000000000300300000000000000000100000000000000010000000000000000000
1111110111111100000001111111100111111110000000000100000000000000010000000000000000000
1000000000000100000001000000000000000010000000000100000000000000010000000000000000000
1000000000000100000001000000000000000010000000000100000000000000010000000000000000000
1000000000000100000001000000000000000010000000000100000000000000010000000000000000000
1000000000000100000001000000000000000010000000000100000000000000010000000000000000000
1000000000000133333331000000000000000013311111111100000000000000010000000000000000000
1000000000000000000000000000000000000000000000000000000000000000010000000000000000000
1000000000000100000000000000000000000000000000000000000000000000010000000000000000000
1111101111111333333331000000000000000013333333333100000000000000010000000000000000000
0000101000000000000001000000000000000010000000000100000000000000010000000000000000000
0000101000000000000001000000000000000010000000000100000000000000010000000000000000000
0000101000000000000001000000000000000010000000000100000000000000010000000000000000000
0001101111000000000001000000000000000010000000000111111011111111110000000000000000000
0001000001000000000003333333300333333310000000000000001010000000000000000000000000000
0001000001000000000000000000100100000000000000000000001010000000000000000000000000000
0001000001000000000000000000100100000000000000000000001010000000000000000000000000000
0001101111000011111100000000100100000000000000000000001010000000000000000000000000000
0000101000000100000010000000100100000000000000000000001010000000000000000000000000000
0000101000001000000001000000100100000000000000000000001010000000000000000000000000000
1111101000010000000000100000100111111100000000000000001010000000000000000000000000000
1000001000100000000000010000100000000100000000000000001010000000000000000000000000000
1000001000100000000000010000111111110100000000000000001010000000000000000000000000000
1000001000100000000000010000000000010100000000000000001010000000000000000000000000000
1000001000100000000000010000111111110111111110000000001010000000000000000000000000000
1000001000100000000000010000100000000000000010000000001010000000000000000000000000000
1000001000100000000000010000100000000000000010000000001010000000000000000000000000000
1000001000010000000000100000100000000000000011111111111010000000000000000000000000000
1000001000001000000001000000100000000000000000000000000010000000000000000000000000000
1000001000000100000010000000100000000000000011111111111110000000000000000000000000000
1110111000000011001100000000100000000000000010000000000000000000000000000000000000000
0010100000000001001000000000100000000000000010000000000000000000000000000000000000000
0010100000000001001000000000111011111111111110000000000000000000000000000000000000000
0010100011111111001111111100001010000000000000000000000000000000000000000000000000000
0010100010000000000000000100001010000000000000000000000000000000000000000000000000000
0010100010000000000000000100001010000000000000000000000000000000000000000000000000000
0010100010000000000000000111111010000000000000000000000000000000000000000000000000000
0010111110000000000000000000000010000000000000000000000000000000000000000000000000000
0010000000000000000000000111111110000000000000000000000000000000000000000000000000000
0011111110000000000000000100000000000000000000000000000000000000000000000000000000000
0000000010000000000000000100000000000000000000000000000000000000000000000000000000000
0000000010000000000000000100000000000000000000000000000000000000000000000000000000000
0000000011111111111111111100000000000000000000000000000000000000000000000000000000000
0000000000000000000000000000000000000000000000000000000000000000000000000000000000000
0000000000000000000000000000000000000000000000000000000000000000000000000000000000000
0000000000000000000000000000000000000000000000000000000000000000000000000000000000000
0000000000000000000000000000000000000000000000000000000000000000000000000000000000000
0000000000000000000000000000000000000000000000000000000000000000000000000000000000000
0000000000000000000000000000000000000000000000000000000000000000000000000000000000000
